Level 2
8 8
++++++++
+a  ttt+
+a  b u+
+** bgu@
+sss gu+
+  d ff+
+ccdee +
++++++++