Level 3
8 8
++++++++
+      +
+      +
+ **s  @
+ aas t+
+ c s t+
+ cbb t+
++++++++