Level 1
8 8
++++++++
+aa   u+
+s  t u+
+s**t u@
+s  t  +
+b   cc+
+b vvv +
++++++++